banish - відганяти
banishment - висилка
wheel - колесо
attitude - відношення, ставлення
to blame sb for sth - звинувачувати когось за щось
facilitate - злегшувати, облегшувати, полегшувати
correctional facility/ prison - виправний заклад/ в'язниця
facilities - місця обслуговування, служби
capital punishment - смертний вирок
punishment - покарання
punish - покарати

engage - обручитися, залучати, вербувати
to engage in - займатись(бути залученим)
engagement - взаємодія
disengage - розєднювати (I disengaged his hand from mine)
disorder - розлад,
adolescent - підіток
mandatory attendance - обов'язкове відвідування
attend - відвідувати, піклуватись, бути присутнім
intend - маєте намір, намырюыватись
slow down - сповільнись
absorb - поглинати

break up into into three groups- розбитись
break up - розійтись
divide into three groups - розділити
to come up with sth придумувати, розробляти щось
to come up to sb - підходити, наближатись до когось

parentheses - круглі дужки
high pitch - висока нотка
overeat - переїсти
keep going - триматись на ногах
out of control - неконтрольований
"power drinks" - енергетичні напої
"plugged in" - підключений
take part - брати участь
make up - приймають рішення
psychologist - психолог
Technology is dividing us as much as uniting us -Технологія розділяє нас так само як і об"єднює
virtually - фактично, практично
virtually impossible - практично неможливо
participants - учасники
to add to your idea - На додаток до вашої ідеї 
not only that, but I would also say that - Не тільки це, але я б хотів також сказати що
your point make me think of - Ваша точка зору заставляэ мене думати
Another thing I'd like to bring up is Ще одна рыч яку я б хотів висвітлити 
you speak of something then, can I also assume that - Ви говорите про щось, можу я також припустити що 
overwhelmed - переповнений, пригнічений
overwhelmed with information - переповнений інформацією
in a way - в деякій мірі, у певному сенсі
by the way - до речі
withdrawal - відвикання, залкжність
drawal - розрив

he go cold turkey - він має ломку
conclusion - висновок

turned into = became
turned sb in to - Здавати когось
feel empty = was unhappy
bombarded with = attacked by a lot of information, data or questions
shaping = influencing in a particular way (forms of communication are seriously shaping our social interactions - форми спілкування серйозно формують наші соціальні взаємодії)
multitasking - багатозадачність
went through = experienced - пройшов 
enhance = improve, enrich
out of the woods = free of dangerous situation - поза небезпечною ситуацыэю
feeding - підживлення
driven - керований
went on a shopping binge - пышов на шопынг гулянку38)	гуляти, «кутить»
to go on a spending spree - Гулянка
build up - нарощувати
upon returning - після повернення
clean state  - З чистого листа
vicious cycle - порочний цикл
head of to - направлятись
pull out - витягати
end up - закінчила
shop 'till you drop - шопінг до упаду
spun out of control - вийшов з підконтролю
to cheer sb up - підбадьорювати, утішати, пожвавлювати 

Do you relate? - чи ви маєте відношення
you are asked to give advice - попросили пораду, спитали пораду
wired, wirelessly - дротовий і бездротовий зв'язок
inferences - висновки
imply - мати на увазі
overuse- надмірне викорситання
What are the warning sign? - що є попереджувальним знаком
unwind, relax - розслабитись відпочити

convince - переконати, вмовити
junkie, addict - наркоман, залежний
addiction - наркоманія, залежність
hooked on, to get addicted to something - підсісти на щось
addicted (he is addicted), addictive - залежний
anxiety - стурбованість
anxious, worried, concerned - заклопотаний
concern - занепокоєння
compulsiveness - компульсивність, вимушена поведінка (inability to control certain behavior)
compulsion, forcing - примус
compel, to force - примушувати
compulsory - примусовий обовязковий
compulsive - примусовий
depression - депресія
depress, discorige - пригнічувати
depressed - пригнічений
depressive - депресивний
enhancement, improvement - посилення, покращення
enhance - покращити
enhanced, improved - посилений, покращений
achievement - досягнення performance - продуктивнысть fulfilment - виконання
fulfill - виконувати
fulfilled, fulfilling - виконаний
isolation - ізоляція
isolate - ізолювати, відокремлювати
isolated, isolating - ізольований
overwhelmed, overwhelming - пригнічений, переповнений
overfill, overwhelm - переповнювати
issue, problem - проблема
problematic - проблематичний
strategy - стратегія
strategist - стратег
strategize - розробляти стратегію
strategic - стратегычний
support - підтримка, підтримувати
supporting, supportive - сприятливий
symptom - симптом(to show signs of illness)
symptomatic of - симпптоматичний
therapy - терапія
therapeutic - терепевтичний

putting together - organization
to put together - to organise
surf, to browse - переглядати (to look for information online)
turning each other in  - здавати один одного(to take sb to the police or authority because they have committed sth wrong)
to devote - присвячувати
therapy - лікування
support group - групи підтримки
to present with - подарувати
to come out - опублікувати, випустити, виявляється
fulfillment - personal satisfaction (personal satisfaction)
acquaintance - знайомство

can't get through the day - не може пройти через день
become increasingly common - стають все більш поширеними

groupie - закохані дівчатка у відомих осіб
what is really going on - що дійсно відбувається
problematic piece - проблематичний шматок
presented with - представлений з
take a walk - прогулюваись

strain деформація
strange дивно
strength сила
severe - важкий
severe wrist pain - важкий біль у зап'ясті
survey - обстеження, 
strive - прагнути
a survey ['sɜːveɪ] / to survey [səˈveɪ] - (соціологічне) опитування, анкетування/ опитувати

intention намір
intent намір 
intend - маєте намір, намырюыватись

interact взаємодіяти
interaction взаємодія
to involve - залучати, тягти за собою, передбачати

treatment - лікування
reveal - виявити
revise переглянути

essential, vital ['vaɪt(ə)l] істотний, суттєвий, життєво-необхідний
excessive - надмірна


increasingly - дедалі
to involve - залучати, тягти за собою, передбачати
clues about the meaning - ключі про сенс

to treat, cure, heal - лікувати
threat - загроза

for while - поки що
evidence свідчення
complicate ускладнити, факти, докази

to treat - розглядати, лікувати
to consider - вважати, розглядати
convince - переконати, вмовити

truncate - укоротити
the process of thinking, improvising, brainstorming - noodling 
maintaining or adding content to a journal-like website - blogging
She decided to go on a spending spree and ended up - flat broke

consider/ regard розглядають
regarding, regardless - відносно, незалежно
certain - певний
certainly - звичайно, певною мірою
conjunction - звязок
for a while - деякий час
assert - стверджувати
fatigue, tiredness - втома
treat - трактувати
insignificant, non essential незначний, несуттєвий
shopaholic - a person addicted to shopping 
support group - a group of people who meet to help each other with a particular problem 


------------------------------------------ part 2
believe, belove, to belong to - вірте, любіть, належати до
seemingly harmless - начебто нешкідливий
harm - шкодити
little white lies or fibs - small unimportant lie
lie-lay-lain - брехати
deceptive, deceitful, misleading - оманливий
misrepresent, falsify - фальсифікувати
withhold, conceal - приховувати
deceive - обманювати
deception - обман
yet admit - все ж допускає 
how common - як часто
condensed version - стиснута версія
exaggerate, hyperbolise - перебільшувати
get into - влаштовувати
prestigious university - престижний університет
claim - вимагати, заявляти
innocent - невинний
guilty - винний
court - суд
get through the day - провести день
acceptable - прийнятний
--------------------
plagiarize - займатися плагіатом
plagiarist - плагіатор
plagiarism - плагіат
tattling on each other, to tattle on sb, to snitch on sb, to turn sb in - tell something bad that another person has done - докладати, доносити
snitch,snow - сніг, доносити
inflated, overrated, exaggerated, overly important - роздутий, переоцінений, перебільшувати, 
veneer, facade - a cover that hides the way someone or something really is - обгортка, лоск
intrusive - affecting someone's private life in an annoying way - навязливий, trusive - трепетно
finely honed - sharpened, perfected - відточений
conceal, withhold - hide something carefully - приховувати
concern, anxiety, anxious, worried, - занепокоєння, тривога
consider - розглядати, вважати
preoccupation, concern with - the condition of thinking about only one thing - турбота
pervasive, widespread - existing or spreading everywhere - всепроникний
trivial, insignificant, non essential - unimportant, of little value - незначний, несуттєвий
mislead, misinform, cheat - make someone believe something that is not true - дезинформувати, вводити в оману
cheater - шахрай
relentless, non stop - continuing without stopping or losing strength - невпинний, невблаганний, relent - змиритися
to back off, to back down, to quit, to give up - відступати, здаватись, кидати
erosion - gradual reduction or wearing down of something - розїдання, ерозія
seriousness - серйозність
are taking in - прийняті
to reveal, to expose,  - виявити, виставити
acknowledge, knowledge - визнати, знання
acknowledge, to admit, confess to sth - визнати
pursuit, to chase sb - переслідування, переслідувати когось
persecution - переслідування
suspect - запідозрювати, підозрілий
assignment - присвоєння
sugarcoat - цукорки, прикрасити, полегшити
coat - пальто
unreliable - ненадійний
approve - схвалювати
fuel - паливо
fuele, feed- заправляти, згодовувати
overconfident - надмірно впевнений
--------------------
they are unclear about - вони незрозумілі

innocent - невинний
guilty - винний
inquest - розслідування
enquiry - розпитування, дізнання
purchase,buy - придбати
a dean - декан
a dean office - деканат
crime was uncovered - злочин був розкритий
get away with - сходити з рук
----------------------
significant - значний
violate - порушити
distribute - поширювати
impose - навязувати
prescribe, subscribe - призначати, підписатися
proper - правильний
grant - давати
readily - легко
restrict - обмежувати
suspend - призупинити
suspend, suspect - призупинити, підозрювати
distinct - чіткий
violation,breach - порушення
prohibit - забороняти
forbidden - заборонений
comply - дотримуватись
behave - вести себе
in compliance with the following - відповідно до наступного
vulnerabilities - вразливості
to ward off threats - щоб запобігти загрозам
RULES OF CONDUCT - ПРАВИЛА ПОВЕДІНКИ
unattended - без нагляду
require - вимагати
in advance - заздалегіть
reconsider - переглянути
stages - етапи
for personal gain - для особистої вигоди
legal prevention - правова профілактика
susceptible - сприйнятливий
suspicious - підозрілий
cautious - обережний
conscious - свідомий
precautions - заходи безпеки
consent - згода
undistributed - нерозподілений
in fact - насправді
-------------------- 
immediate, intermediate - негайний, середній
to please another - порадувати іншого
awareness of - усвідомлення
aware - усвідомлювати
relentless erosion of trust - невпинна ерозія довіри
it can be approached from a variety of perspectives - до цього можна підійти з різних точок зору
interpersonal - міжособистісний
psychiatrist [saɪ'kaɪətrɪst] - психіатр
tend - схильний
to tempt - спокушати
absorbed - захоплений, absorb - поглинати
confident - впевнений
beneath - нижче, під
beyond - далі
beside - поруч
behind - позаду
lacking a core - відсутність ядра
ultimately - в кінцевому підсумку
to be trapped - бути в пастці
to be trapped in his lies - бути в пасці його брехні
start out with - почати з
deliberate - навмисний
Intentionally - Навмисно
accidentally - випадково
pretty obvious, less obvious - досить очевидний, менш очевидний
we are notified - нам повідомлено
no advance notice of lying - немає попереднього повідомлення про брехню
magician - маг
anger - гнів
requires - вимоги
in a mocking fashion - насмішливо
to protect yourself from the threat of physical harm - щоб захистити себе від загрози фізичної шкоди
damage, harm - пошкоджувати, шкодити
malicious - шкідливий
to win the admiration - щоб виграти захоплення
admire - захоплюватись
awkward - незграбний
acquire - придбати, здобувати
enquiry - розпитування, дізнання
to get out - вийти
embarrassment - збентеження, нерішучість
greatest  - найбільший
complete - цілковитий, завершити
adolescents - підлітки
consequence ['kɔnsɪkwəns] - наслідок
inferences,findings - висновки
because of - тому що, внаслідок
eliminate, exclude  виключити - виключити
handkerchief - носові хустки
ultimately trapped - в кінцевому підсумку потрапляє в пастку
confirming - підтверджуючи
deter - стримувати
variety of perspectives - різноманітність перспектив
have you cataloged sort of - ти каталогізував якийсь
to put in - задіти
core [kɔː] = the central part of sth
to put in doing sth (coll) = to spend time and efforts
to put one over on sb (coll) = to fool sb
The rule of thumb = a practical rule based on experience
reestablish - відновити
itself - сама по собі
consistent sense - Послідовний, цілісний зміст

------------------------------
to resemble sb = to look like sb - бути схожим на когось
to rake up the past - ворушити минуле
to piggyback on sb = to ride on sb’s back - впасти комусь на хвіст 
uncanny = mysterious - таємничий

elating = encouraging = inspiring - підбадьорування
to trespass on sb/sth = to enter sb’s area without permission
to mull over sth = to ponder = to reflect on - обдумати

incredibly successful - неймовірно успішний
trespassing - вторгнення
forbidden to me - заборонено мені
family legacy - сімейна спадщина
it is going to come out - це випливе
put the pieces - cкласти все разом

occur, happen - виникати, статися
closet - шафа
elate - окриляти
persecution - переслідування

----------------------------------
really, in fact - дійсно, насправді
fiction - вигадка
memoir - мемуари
fidget - метушитись 
certain, precise - певний, точний
reveal - розкривати
fib - брехати

finely honed - sharpened, perfected - відточений
inflated, overrated, exaggerated, overly important - роздутий, переоцінений, перебільшувати, 
mislead, misinform, cheat - make someone believe something that is not true - дезинформувати, вводити в оману
tattling on each other, to tattle on sb, to snitch on sb, to turn sb in - tell something bad that another person has done - докладати, доносити
to mull over sth = to ponder = to reflect on - обдумати
conceal, withhold - hide something carefully - приховувати
preoccupation with, concern with - the condition of thinking about only one thing - турбота
get away with - cходити з рук

----------------------------------
fudged - вигадувати(misrepresent, falsify - фальсифікувати)
manipulate - підтасовувати
bluff - блеф
to go down a slippery slope - стати на слизький шлях
headed toward disaster - назустріч катастрофі
to fess up to, to admit, to confess - визнавати
a recipe for disaster - рецепт катастрофи
failure - провал
whopper, big lie- брехня
jealous, envious of - ревнивий, заздрісний
two-faced, hypocritical, hypocrite - дволикий, лицемір
deceptive, deceitful, misleading - оманливий
chubby - пухнастий
up front, honest - чесний
to pull the wool over everyone's eyes - Замилити очі
can’t stand, can’t bear погано переносити, не виносити щось 
snap - easy task -  простий таск
inconclusive - непереконливо
to spot - визначити, помітити

----------------------------------
insist - наполягай
to claim, to acclaim - cтверджувати, заявляти, вимога, претензія | проголошувати, повідомляти
disclaimers - відмова від відповідальності
excuse - вибачення
missing - відсутній; зниклий; який загубився
impeccable - бездоганний
accurately, certain, exactly, explicitly, precisely - точно
explicitly - явно, точно, precisely - точно
contradiction - протиріччя

----------------------------------
elaborate | evaluate, estimate - розробити | оцінити
suggest - запропонувати
assumption - припущення
prior - попередньо
measurable - вимірюваний
what's the harm? - що поганого
expel - виганяти
ethical - етичний
turned in something - Здавати щось
flip side - зворотна сторона
to take on - набувати, приймати форму
take into consideration - брати до уваги
flip side - зворотна сторона
volunteer - зголошуватися
drug test - тест на наркотики
cut cone - 
intense - інтенсивний
relentless pursuit - невтомне переслідування
concern, anxiety, anxious, worried, - занепокоєння, тривога
apparently - мабуть
fibb - трішки брехати
con - шахрай
snap - хватка
fidget - метушитись 
erode - роз'їдати
are taken in academia - прийняті в академії
to respond - відповісти
to recall - згадувати
caption- підпис